1111111111111
1001000C0E0C1
1P000111E1001
1111111111111
