1111111111111
1001000C0E0C1
1111111111111
1P00000001001
1111111111111
